1111111
1P00001
1000E01
100C001
1111111