1111111
1P00001
10111E1
10000C1
1111111