1111111111111111111111111
1P0000000000C000000000001
1010111110111111101110101
1010000000100000100000101
1010111010111010101110101
1010001010000010100000101
1011111010111010111010101
1000C000100000000000000E1
1011111010111111101110101
1000000010000000100000101
1010111010111010101110101
1010000010000010100C00101
1011111110111110111110101
10000000000C0000000000001
1010111010111010101110101
1010000010000010100C00101
1011111110111110111110101
10000000000C0000000000001
1010000010000010100C00101
1011111110111110111110101
10000000000C0000000000001
1010111010111010101110101
1010000010000010100C00101
1011111110111110111110101
10000000000C0000000000001
1010000010000010100C00101
1011111110111110111110101
10000000000C0000000000001
1010111010111010101110101
1010000010000010100C00101
1011111110111110111110101
10000000000C0000000000001
1010000010000010100C00101
1011111110111110111110101
10000000000C0000000000001
1010111010111010101110101
1010000010000010100C00101
1011111110111110111110101
10000000000C0000000000001
1111111111111111111111111